25
71
114
 0  0  0  0  0  0 -5  0 -5  0  0 -5  0  0 -2  0  0 -5 -6  0  0  0  0  0  0
 0  0 -2  0 -5  0  0 -5  0 -2  0  0  0  0  0  0  0 -5 -1  0 -2  0  0  0  0
 0  0  0  0  0 -1  0  0  0  0  0 -2  0  0 -5  0  0 -5  0 -2  0  0  0 -5  0
 0  0  0  0 -5 -5 -3  0 -3  0  0  0 -5 -1  0 -5  0  0  0  0  0  0  0  0  0
 0 -1  0  0 -5 -1  0 -3  0  0 -5 -1  0  0 -5  0  0  0  0  0 -5 -5  0 -4  0
 0  0 -1  0  0  0  0  0 -2 -6  0  0  0  0 -5  0 -2  0 -5  0 -6 -5 -5  0  0
-6 -5  0  0  0 -5  0  0  0  0  0  0  0 -5 -5  0  0  0  0  0  0 -5  0  0 -5
-5 -1 -5  0  0  0  0  0 -5  0 -5  0  0  0  0  0  0  0  0  0 -5  0  0 -5  0
 0  0  0  0  0 -1  0  0 -5  0  0  0  0  0 -1  0 -5 -6  0 -5  0 -3  0  0 -5
 0  0  0 -5  0  0  0  0  0  0  0  0  0  0  0  0  0  0  0 -1  0  0  0 -3  0
-6  0 -5  0 -5 -6 -6  0 -1  0 -1 -5 -5 -5 -5  0  0 -5  0  0 -5  0  0  0  0
 0  0  0 -5  0  0 -5  0  0  0 -1  0  0  0 -5  0  0  0  0  0 -5  0 -5  0 -5
 0  0  0 -5  0  0  0  0  0  0 -5  0 -5  0 -2  0  0  0  0  0  0 -5  0  0  0
-2  0 -5  0 -6  0  0  0  0  0 -5  0  0  0 -5  0  0  0 -6  0  0 -5  0  0  0
 0  0  0  0 -6  0  0 -6  0  0 -5 -5 -1 -5 -5  0 -6  0 -5 -5 -5  0 -1  0 -5
 0 -5  0  0  0 -5  0  0  0  0  0  0  0  0  0  0  0  0  0  0  0 -5  0  0  0
-5  0  0 -5  0 -3  0 -5 -5  0 -2  0  0  0  0  0 -6  0  0 -6  0  0  0  0  0
 0 -5  0  0 -5  0  0  0  0  0  0  0  0  0 -5  0 -5  0  0  0  0  0 -5 -5 -5
-5  0  0 -2  0  0  0  0  0  0 -5 -1  0  0  0  0  0  0  0 -6  0  0  0 -5 -5
 0  0 -3 -5 -5  0 -1  0 -5  0 -5  0  0  0  0 -5 -5  0  0  0  0  0 -5  0  0
 0 -2  0 -1 -5  0  0  0  0  0 -5  0  0 -5 -6  0  0 -1  0 -5 -2  0  0 -2  0
 0  0  0  0  0  0  0  0  0 -2  0 -2 -6  0  0  0 -5  0 -5 -5 -5  0  0  0  0
 0 -1  0  0  0 -2  0 -5  0  0 -4  0  0 -5  0  0  0  0  0 -5  0  0  0  0  0
 0  0  0  0 -5  0 -5 -5  0  0  0  0  0  0  0 -5  0 -5  0  0 -5  0 -3  0  0
 0  0  0  0  0  0 -1 -6  0  0 -5  0  0 -5  0  0 -2  0 -2  0  0  0  0  0  0
