14
24
24
 0  0 -5  0  0  0  0  0  0  0  0 -5 -6  0
-1  0  0  0 -5  0  0 -5  0  0 -2  0  0  0
-5  0  0  0  0  0 -5  0  0 -5 -5  0  0 -5
 0 -5 -1 -5  0  0  0 -2  0  0 -5  0  0  0
 0  0 -5  0  0  0 -5  0  0  0  0  0 -2  0
 0  0  0  0  0  0  0  0  0  0  0  0  0  0
 0 -5  0 -5  0  0  0  0  0 -2  0 -3  0  0
 0  0 -3  0 -3  0  0  0  0  0 -5  0 -2  0
 0  0  0  0  0  0  0  0  0  0  0  0  0  0
 0 -5  0  0  0  0  0 -1  0  0  0 -5  0  0
 0  0  0 -1  0  0 -2  0  0  0 -2 -1 -6  0
-6  0  0 -6 -2  0  0 -5  0  0  0  0  0 -5
 0  0  0 -5  0  0 -2  0  0 -1  0  0  0 -1
 0 -5 -1  0  0  0  0  0  0  0  0 -5  0  0
