7
8
1 1
1 5
4 1
4 5
5 1
5 2
5 4
5 5
2 2 2 2 2 2 2
2 0 0 0 0 0 2
2 0 3 3 3 0 2
2 0 3 5 3 0 2
2 0 3 3 3 0 2
2 0 0 0 0 0 2
2 2 2 2 2 2 2