7
3
3 3
4 2
4 3
2 2 2 2 2 2 2
2 0 0 0 0 2 2
2 0 2 5 0 2 2
2 0 3 3 0 2 2
2 0 0 3 0 2 2
2 0 0 0 0 2 2
2 2 2 2 2 2 2