5
1
1 2
2 2 2 2 2
2 2 0 0 2
2 2 3 5 2
2 2 0 0 2
2 2 2 2 2