14
20
28
 0 -5  0  0  0  0  0 -2  0 -6 -1 -5  0  0
 0  0  0  0  0  0  0  0  0 -5  0  0  0 -5
-5  0  0 -5  0  0 -5  0  0  0 -1  0  0  0
-5  0 -4  0  0  0 -5  0  0  0  0 -5  0  0
-5 -5  0  0 -5  0 -5  0  0 -5  0  0  0  0
 0  0  0  0  0  0  0  0  0  0  0  0  0  0
-5  0  0  0  0  0  0  0  0 -1 -1 -1  0  0
 0  0 -6 -5 -1  0  0  0  0  0  0  0  0 -6
 0  0  0  0  0  0  0  0  0  0  0  0  0  0
 0  0  0  0 -2  0  0 -2  0 -5  0  0 -5 -5
 0  0 -5  0  0  0  0 -5  0  0  0 -4  0 -5
 0  0  0 -1  0  0  0 -5  0  0 -2  0  0 -5
-2  0  0  0 -1  0  0  0  0  0  0  0  0  0
 0  0 -6 -6 -5  0 -5  0  0  0  0  0 -5  0