8
4
3 3
3 5
4 3
5 4
2 2 2 2 2 2 2 2
2 2 2 0 2 2 2 2
2 2 2 0 2 2 2 2
2 2 2 3 0 3 0 2
2 0 0 3 5 2 2 2
2 2 2 2 3 2 2 2
2 2 2 2 0 2 2 2
2 2 2 2 2 2 2 2